9 9 3 -1 -1 2 9 1 9 3
5 5 6 6 6 4 3 1 6 1
4 3 4 -1 -1 6 3 9 4 1
3 1 1 -1 -1 7 7 2 4 7
3 5 8 6 8 4 6 1 9 9
7 4 -1 -1 -1 -1 4 4 9 1
3 2 -1 -1 8 4 7 2 6 1
-1 -1 -1 3 6 -1 -1 -1 -1 -1
1 8 8 1 5 1 4 3 8 5
8 7 5 3 7 2 -1 7 5 1